17,17
#################
#    #          #
###d##          #
#               #
#               #
#               #
#               #
#               #
#               #
#               #
#               #
########d########
#               #
#               #  
#               # 
#       g       #
#################
8,2,START
3,10,KEY,RED
3,2,DOOR,RED
14,10,KEY,YELLOW
8,11,DOOR,YELLOW