17,17
#################
#    #          #
###d##          #
#               #
#               #
#               #
#               #
#               #
#               #
#               #
#               #
########d########
#               #
#               #  
#               # 
#       g       #
#################
8,2,START
3,10,KEY,YELLOW
3,2,DOOR,YELLOW
14,10,KEY,RED
8,11,DOOR,RED