21,15
#####################
#      ###  #####   #
#  #  #   # #    #  #
# # # #   # #  # #  #
### ##  # ##   # #  #
#       #    # # ####
################ ####
#   #         #    g#
###  # #  ####  #####
#  #   #  ####  #   #
#  #   #        #   #
#  #### ##    ###   #
#                   #
#         ####      #
#####################
1,5,ENEMY,SMART
1,7,START
