21,14
#####################
# g #          #    #
##d##          #    #
##d##          #    #
#                   #
#                   #
#                   #
#              ######
#                   #
#                   #
######   #          #
#        #          #
#        #          #
#####################
10,4,START
19,1,TOKEN,1
16,1,ENEMY,FOLLOW,DOWN
18,4,ENEMY,STRAIGHT,RIGHT
16,12,TOKEN,1
17,12,KEY,BLUE
2,3,DOOR,TOKEN,2
2,2,DOOR,BLUE