17,17
#################
#    #          #
###d##          #
#               #
#               #
#               #
#               #
#               #
#               #
#      fff      #
#      f f      #
########d########
#               #
#               #  
#               # 
#       g       #
#################
8,2,START
3,10,KEY,GREEN
3,2,DOOR,GREEN
8,11,DOOR,TOKEN,3
1,1,BOOT,FIRE
1,8,ENEMY,STRAIGHT,RIGHT
1,12,ENEMY,STRAIGHT,RIGHT
3,1,TOKEN,1
13,5,TOKEN,1
11,10,TOKEN,1